1,6,6,0,0,0,6,6,1
1,4,0,0,0,0,0,4,1
1,1,1,1,2,1,1,1,1
1,6,6,0,0,0,6,6,1
1,4,0,0,0,0,0,4,1
1,1,1,1,2,1,1,1,1
1,6,6,0,0,0,6,6,1
1,4,0,0,0,0,0,4,1
1,1,1,1,2,1,1,1,1
1,0,0,0,0,0,0,0,1
